TTTTTTTTT         TTTTTT
TTTTTTTT         TTTTTTT
TTTTTTT         TTTTTTTT
TTTTTTT         TTTTTTTT
TTTtTTT         TTTTTTTT
TTTTTTT      C  TTTTTTTT
TTTTTTT         TTtTTTTT
TTTTTTT         TTTTTTTT
TTTTTTT         TTTTTTTT
TTTTTTT            TTTTT
TTTTTTT      TT    TTTTT
TTtTTTT     TTT   TTTTTT
TTTTTTT         TTTtTTTT
TTTTTTT         TTTTTTTT
TTTTTTT         TTTTTTTT
TTTTTTT         TTTTTTTT
TTTTtTT          TTTTTTT
TTTTTTT         TTTTTTTT
TTTTTTTT       TTTTTTtTT
TTTTTTTTT     TTTTTTTTTT
