TTTTTTTTT         TTTTTT
TTTTTTTT         TTTTTTT
TTTTTTT         TTTTTTTT
TTTTTTT         TTTTTTTT
TTTtTTT         TTTTTTTT
TTTTTTT      C  TTTTTTTT
TTTTTTT         TTtTTTTT
TTTTTTT         TTTTTTTT
TTTTTTT         TTTTTTTT
TTTTTTT         TTTTTTTT
TTTTTTT         TTTTTTTT
TTtTTTT         TTTTTTTT
TTTTTTT         TTTtTTTT
TTTTTTT         TTTTTTTT
TTTTTTT    B    TTTTTTTT
TTTTTTT         TTTTTTTT
TTTTtTT   EAD    TTTTTTT
TTTTTTT         TTTTTTTT
TTTTTTTT       TTTTTTtTT
TTTTTTTTT     TTTTTTTTTT
